//1,2,3,4,5,6,7,8,9
682,683,684,684,684,684,685,686,687
714,715,716,716,716,716,717,718,719
746,747,748,748,748,748,749,750,751
778,779,780,780,780,780,781,782,783
810,811,812,17,17,17,17,814,815
864,865,17,17,17,17,17,898,899
896,897,17,17,17,17,17,898,899
864,865,17,17,17,17,17,974,975
1004,1005,996,806,17,807,997,1006,1007
